X X X X X O O O X X E X X X X X X X X X
X X X X X O O O X X O X X X X X X X X X
X X X X X O O O O O O X X X X X X X X X
X X X X X O O O O O O X X X X X X X X X
X X X X X O O X X X O X X X X X X X X X
X X X X X O O O O O O X X X X X X X X X
X X X X X X X O X X X X X X X X X X X X
X X X X X O O O O O O O O O O O X X X X
X X X X X O O X O O O O X X O O X X X X
X X X X X O O X O O O O X X O O X X X X
X X X X X O O O O O X O O O O O X X X X
X X X X X O O O O O X O O O O O X X X X
X X X X X X X X X X X O O X X X X X X X
X X X X X X X X X X X O O X X X X X X X
X X X X X X X X X X X S X X X X X X X X
X X X X X X X X X X X X X X X X X X X X
X X X X X X X X X X X X X X X X X X X X
X X X X X X X X X X X X X X X X X X X X
X X X X X X X X X X X X X X X X X X X X
X X X X X X X X X X X X X X X X X X X X