X X X X S X X X X X X X X X X X X X X X
X X X X O X X X X X O O O O O X X X X X
X O F F O O O O X X O O O O O X X X X X
X O O O O O O O X X O O O O O X X X X X
X X F F F O O O X X O O O O O X O O O X
X O O O O O O O X X O O O O O X O X X X
X O O O X X X X X X F K F O O O O X X X
X X X X X X X X X X X X X X X X X X X X
X X X X X X X L O X X X X X X X X X X X
X X O X X X X O O X X O O X O O X X X X
X X O O O O O O O X O O O O O K O O X X
X X O O O O O O O X O O O O O O O O X X
X X O O O O O O O X O O O O O O O O X X
X X O O O O O O O X O O O O O O O O X X
X X O O O O O O O X X X X O O X X X X X
X X O X X X X O O F F F O O O X X X X X
X X O O O O O O O O O O O O O L O O O X
X X X X X X O O X X X X X X X X X E O X
X X X X X X X X X X X X X X X X X X X X
X X X X X X X X X X X X X X X X X X X X