X X X X X X X X X X X E X X X X X X X X
X X X X X X X X X X X O X X X X X X X X
X X X X X O O O O O O L O O X X X X X X
X X O O O O O O O O O O O O X X X X X X
O O O X X X X X O O O O O O X X X X X X
O O O O O O O O L O O O O O O O X X X X
O O K O O O O F X X X X X O O O X X X X
X X O X X X O O X X X X X O O O X X X X
X X O O O O O O K X X X X O O O X X X X
X X X X X X O O O O O O O O O O X X X X
X X X X X X O O O O O O X X X X X X X X
X X O X X X O O O O X X O O O O O X X X
X X O X X X O O O O X X O X O O O X X X
X O O X X X X O O O X X O O O O O X X X
X O O O O O X O O O O O O O O O O X X X
X X O O O O X X O O O O O O O O O X X X
X X O O O O X X O O O O O O O O O X X X
X X O O O O X X O O O O O O O O O X X X
X X X X X X X X O O O O O O O O O X X X
X X X X X X X X O O O O S O O O O X X X