S O O E O O F O O O O O O O O X O O O O
O O O O O O F O O O O O X X O O O O O O
O O O O F X X O O K O L X O O F O O O O
O O O O O O X O O O O F O O O F O O O O
O O O O O O O O O O O O O O O O O O K O
F O O O O X X O O O O O F O F F O O O O
O O O O O O O O O F O X O O O O O O O O
O O O F O O O X O O O X O O O O O O O O
O O O O O O O X O O O L O O O O O X F O
O O O O O O L X O O X O O K O X X O O O
O F O O X X O K O O O O O O O O O O O O
O O O O O O O O O O O O O O O L O O O O
O O O O O O O O O O O O O O O O O O O O
O O O O F O O O O O F O O X X O O O F F
O O O F O O O O O O O O O X O O O O O F
O O O O O O O F O O O O O X O O O O O L
O X X X O O O O O O O O O O F F O O O O
O O O X O O K O O O O X X O O O O O O O
O O O O X O X O O O O O O O O O O O O O
O F O O X O O O O O F F F F F F O F F F